Author: Dries De Clercq
Comment:
"ZONE 26"
117 levels by Dries De Clercq

AuthorName: Dries De Clercq <de3s@hotmail.com>
AuthorPage: http://www.freewebs.com/dries/soko.htm
LevelsLink: http://www.freewebs.com/dries/images/zone26.zip (xsb)
            http://www.freewebs.com/dries/images/zone26.txt

A huge collection where all levels have a floor size of 26 squares.
Most of these levels are quite difficult !
Comment-End:

;Level 1
_####___
_#-.####
##.----#
#..-##-#
#-#-##-#
#-$--$-#
##-$$###
_#@--#__
_#####__
Title: Islands
Author: Dries De Clercq <26-4-51>

;Level 2
_#######
_#-----#
##.-##-#
#-.$+#-#
#--$*#-#
###-$--#
__#--###
__#--#__
__####__
Title: Logical
Author: Dries De Clercq <26-4-52>

;Level 3
_#####__
_#---#__
_#$#-###
_#--$--#
##-.-..#
#-$##.-#
#@$---##
####--#_
___####_
Title: Fluently
Author: Dries De Clercq <26-4-60>

;Level 4
___####__
___#--#__
___#-.#__
####--###
#-.--..-#
#-$#$$--#
##@$-#-##
_###---#_
___#####_
Title: 4 2 die 4
Author: Dries De Clercq <26-4-61>

;Level 5
_######_
_#.---#_
##-##-#_
#-..$-##
#---#$-#
#-.$-$@#
##--####
_#--#___
_####___
Title: Soko-San
Author: Dries De Clercq <26-4-61b>

;Level 6
_####___
_#--####
_#$--$-#
_#-.-.-#
##$##.-#
#--.#-##
#--$--#_
####-@#_
___####_
Title: Go Round 1
Author: Dries De Clercq <26-4-63>

;Level 7
_#####__
_#---#__
_#-#$#__
_#-$@###
##-#$--#
#--.-.-#
#--.#$-#
###--.##
__#####_
Title: Stock
Author: Dries De Clercq <26-4-64>

;Level 8
_####___
_#--####
_#$--$-#
_#-.-.-#
##$##.-#
#-@#.-##
#-$---#_
####--#_
___####_
Title: Go Round 2
Author: Dries De Clercq <26-4-65>

;Level 9
__#####_
###---#_
#-$$#-##
#-$-..-#
#-#-..-#
#-#$$--#
#.-@####
#####___
Title: Excluded
Author: Dries De Clercq <26-5-52>

;Level 10
#######
#-----#
#-#.#-#
#-$-$-#
##-**-#
_#@#.-#
_#-$--#
_###-.#
___####
Title: Collider
Author: Dries De Clercq <26-5-53>

;Level 11
_#####__
##--.###
#@*--$-#
#-#$.-.#
#---#$.#
###$#--#
__#----#
__######
Title: 5 To Go
Author: Dries De Clercq <26-5-53b>

;Level 12
___#####
####--.#
#@$.$#-#
#$#.--.#
#.---#-#
#--$-$-#
#--#####
####____
Title: Pillars
Author: Dries De Clercq <26-5-54>

;Level 13
######__
#--.-###
#-#-$--#
#--.-#-#
##.-$$.#
_#$#-$-#
_#+--###
_#####__
Title: Socialising
Author: Dries De Clercq <26-5-54b>

;Level 14
######__
#----#__
#.#$-#__
#-#.-###
#.$--$-#
#-#-**@#
#-----##
#######_
Title: The Door
Author: Dries De Clercq <26-5-54c>

;Level 15
__####_
_##--##
_#--*+#
##-#-$#
#-$-*-#
#-#-$-#
#.--.-#
###---#
__#####
Title: The Fly
Author: Dries De Clercq <26-5-55>

;Level 16
#######
#-----#
#-#-.-#
#---$-#
##-#*-#
_#$#.-#
_#--$*#
_###@.#
___####
Title: Prairie Dog
Author: Dries De Clercq <26-5-55b>

;Level 17
___####_
####-@#_
#-$-*$#_
#--#--##
#--$*--#
#-..-#-#
###---.#
__######
Title: Order
Author: Dries De Clercq <26-5-55c>

;Level 18
__####___
__#--#___
###--#___
#--*+#___
#-#-$###_
#-$.*--##
##---$--#
_####-.-#
____#####
Title: Closing
Author: Dries De Clercq <26-5-56>

;Level 19
#####___
#---####
#-$--$-#
##..$-.#
#--#.$-#
#---*@##
####--#_
___####_
Title: Preparation
Author: Dries De Clercq <26-5-57>

;Level 20
######_
#---.#_
#-$#-##
##@$.-#
##$*--#
#-.-.-#
#-$--##
#--###_
####___
Title: Escape From Alcatraz
Author: Dries De Clercq <26-5-58>

;Level 21
#######_
#+----##
#---$$-#
#.#$---#
#.#--$-#
#.#$####
#.--#___
#####___
Title: Rotating Block
Author: Dries De Clercq <26-5-58b>

;Level 22
####___
#--####
#-.@--#
#$-#$-#
#-$--##
#.*.$#_
#-#--#_
#--.-#_
######_
Title: Thinking Process
Author: Dries De Clercq <26-5-60>

;Level 23
_#######
_#-----#
##$-##.#
#-$--#.#
#@$$--.#
##--$..#
_#--####
_####___
Title: Picky
Author: Dries De Clercq <26-5-61>

;Level 24
_#####__
_#---#__
_#-$$#__
_#-$@#__
##-#$###
#..--$-#
#-..-.-#
##---###
_#####__
Title: Sokogravity 1
Author: Dries De Clercq <26-5-62>

;Level 25
#####___
#---###_
#-#*--##
#---.--#
###$-*-#
__#@$.-#
__#$#-##
__#.--#_
__#####_
Title: My Chain For You
Author: Dries De Clercq <26-5-62b>

;Level 26
_#####_
_#-.-#_
_#$.-##
_#-..-#
_#$$--#
##@#-##
#-$$--#
#---.-#
#######
Title: Not Too Far
Author: Dries De Clercq <26-5-63>

;Level 27
_####___
_#@-###_
_#$$--#_
_#-$--#_
##-#.###
#.--.--#
#-$.-*-#
#####--#
____####
Title: Breakpoint
Author: Dries De Clercq <26-5-63b>

;Level 28
########
#--.-*@#
#--*$.-#
##-*-$-#
#--#-###
#----#__
#--###__
####____
Title: Arranged
Author: Dries De Clercq <26-5-63c>

;Level 29
__#####_
__#---#_
_##--$##
_#--.$@#
##.#$#-#
#--$.*.#
#----###
###--#__
__####__
Title: 2-3-2
Author: Dries De Clercq <26-5-64>

;Level 30
__####__
__#-@#__
__#-$###
###*---#
#-.--#-#
#-$$..-#
#-.$#-##
###---#_
__#####_
Title: Reach Out
Author: Dries De Clercq <26-5-65>

;Level 31
__####__
_##--#__
##-.-###
#@$.$--#
#-$$-#-#
##--.-.#
_#-#$###
_#--.#__
_#####__
Title: Look At That !
Author: Dries De Clercq <26-5-65b>

;Level 32
__####__
__#-@#__
###-$###
#--$.-.#
#-$*-#-#
##-.-#-#
_#-.$--#
_##--###
__####__
Title: Intersection
Author: Dries De Clercq <26-5-65c>

;Level 33
___####_
___#--#_
_###--##
_#@$---#
##$#-$-#
#..$$#-#
#.-----#
#..#####
####____
Title: Classic Sokoban
Author: Dries De Clercq <26-5-65d>

;Level 34
_#####__
_#---#__
_#-#-###
_#.-$--#
_#-#.*-#
##*@$-##
#--*--#_
#---###_
#####___
Title: Checkery
Author: Dries De Clercq <26-5-65e>

;Level 35
__######
###--.-#
#--$#--#
#--*-.-#
##$#-*-#
_#-@$--#
_####.-#
____####
Title: Pinball
Author: Dries De Clercq <26-5-65f>

;Level 36
__#####_
__#---#_
__#$$-#_
__#@$-#_
###$#-#_
#-$---##
#-.-..-#
###-..-#
__######
Title: Sokogravity 2
Author: Dries De Clercq <26-5-66>

;Level 37
__####__
__#--#__
###+$###
#-$$.--#
#----#-#
###*.-.#
__#-#$-#
__#----#
__######
Title: Know How
Author: Dries De Clercq <26-5-66b>

;Level 38
_#####__
_#.--#__
##-#$###
#-.-.$-#
#--.---#
#-#$-###
#.-$$#__
###@-#__
__####__
Title: Many Ways
Author: Dries De Clercq <26-5-66c>

;Level 39
####____
#--#____
#+-#####
#$$----#
#..*$--#
#.-$-###
#-##-#__
#----#__
######__
Title: Strucked Down
Author: Dries De Clercq <26-5-67>

;Level 40
__####__
_##-.###
_#--$@.#
##*-$.-#
#-.-#-##
#--$$-#_
#-#-###_
#---#___
#####___
Title: Obstacles
Author: Dries De Clercq <26-5-67b>

;Level 41
_#######
_#-.$--#
##$----#
#@-$-###
#-#.-#__
#.*.-#__
##-#$#__
_#---#__
_#####__
Title: Addition
Author: Dries De Clercq <26-5-68>

;Level 42
#####___
#---###_
#-.$-.##
#-$-#$-#
#$.----#
#--#$###
#..@-#__
######__
Title: Structural
Author: Dries De Clercq <26-5-68b>

;Level 43
__#####_
__#---#_
###.$.##
#.-$$--#
#-##.--#
#---*@##
###-$-#_
__#--##_
__####__
Title: Shelter
Author: Dries De Clercq <26-5-69>

;Level 44
__#####_
__#---#_
###*--##
#--.$.@#
#-$#.--#
##--*-##
_##-$-#_
__#--##_
__####__
Title: Round and round
Author: Dries De Clercq <26-5-69b>

;Level 45
########
#---$-.#
#-.-.-.#
#--$-#-#
##-#-$-#
_#$#$###
_#.@-#__
_#####__
Title: S
Author: Dries De Clercq <26-5-69c>

;Level 46
__#####
_##---#
_#----#
_#*-.##
_#.-##_
##*-#__
#@$-#__
#$-$#__
#.--#__
#---#__
#####__
Title: Worm
Author: Dries De Clercq <26-5-70>

;Level 47
___####_
__##--#_
###-*-#_
#.--*-##
#-#-*--#
#-$$@-.#
###---##
__#--##_
__####__
Title: Fragile
Author: Dries De Clercq <26-5-70b>

;Level 48
__#####_
__#---##
__#$#--#
__#----#
__#-.-##
###$*-#_
#-@-*$#_
#-..--#_
#######_
Title: 90?
Author: Dries De Clercq <26-5-71>

;Level 49
__####___
__#--#___
__#-.##__
###-*-###
#@.$$---#
#-$-----#
####$#.##
___#--.#_
___#####_
Title: Continue
Author: Dries De Clercq <26-5-71b>

;Level 50
__####__
__#--###
__#-$-@#
__#-$..#
###-$#.#
#.-$.$-#
#-#---##
#---###_
#####___
Title: Addition
Author: Dries De Clercq <26-5-73>

;Level 51
_####__
_#-@#__
_#-$#__
##$.#__
#-$-#__
#-.-###
#..-$-#
#-----#
##.$###
_#--#__
_####__
Title: The Root
Author: Dries De Clercq <26-5-75>

;Level 52
____####
__###-@#
_##.-*$#
##--#*-#
#-.----#
#--$-$-#
#####-.#
____#--#
____####
Title: The sledge
Author: Dries De Clercq <26-5-75b>

;Level 53
_####___
_#-@#___
##$$###_
#-.$-.#_
#-.-#-##
#-*$---#
##-#---#
_#.--###
_#####__
Title: 75 Pieces Of A Cake
Author: Dries De Clercq <26-5-75c>

;Level 54
__####__
__#-.###
###-.--#
#-$-$--#
#---#.##
###-$$-#
__#--$+#
__#-.###
__####__
Title: Heart
Author: Dries De Clercq <26-5-75d>

;Level 55
__####___
__#--#___
###-.##__
#--$--###
#--...--#
###-$-*-#
__#$#$###
__#-@-#__
__#####__
Title: Wall 3.5 Beta
Author: Dries De Clercq <26-5-77>

;Level 56
__####__
__#@-#__
###*$###
#--$-$-#
#.-..--#
#-#--###
#.#-$#__
#----#__
######__
Title: Epicenter
Author: Dries De Clercq <26-5-77b>

;Level 57
_####____
_#+-#____
##$-#####
#-.$--$-#
#--$----#
##.-#####
_#*-#____
_#.-#____
_#--#____
_####____
Title: X
Author: Dries De Clercq <26-5-78>

;Level 58
_####___
_#--####
##-+---#
#-$$---#
#-.$#.$#
###-*-.#
__#--###
__#--#__
__####__
Title: Switch 2
Author: Dries De Clercq <26-5-79>

;Level 59
_#####__
##-.-##_
#-----#_
#-.$.*##
##-#$--#
_#--$.-#
_###-$##
___#-@#_
___####_
Title: The 5 Elements
Author: Dries De Clercq <26-5-82>

;Level 60
####____
#--#####
#-$----#
#------#
###$#$##
__#-.*-#
__#-.*@#
__#-.###
__####__
Title: ER
Author: Dries De Clercq <26-5-82b>

;Level 61
__####___
__#--##__
__#-.-#__
###$*-###
#---*--.#
#-@$--$-#
######-.#
_____#--#
_____####
Title: Easy 83
Author: Dries De Clercq <26-5-83>

;Level 62
__####__
###--#__
#--$-###
#..*$-@#
#---.$-#
#-.#-###
##$#-#__
_#---#__
_#####__
Title: 85
Author: Dries De Clercq <26-5-85>

;Level 63
_####__
_#--###
_#--$-#
##$$@.#
#--#$.#
#.-.$.#
#---$##
##-.-#_
_#####_
Title: Explosive
Author: Dries De Clercq <26-6-55>

;Level 64
_#####__
##---##_
#-..--#_
#-*.-$##
#-.#---#
##$$$$-#
_#.-@###
_#####__
Title: The cage
Author: Dries De Clercq <26-6-55b>

;Level 65
___#####
####---#
#----$-#
#-.*$+##
##$.$$-#
_#.--.-#
_####--#
____####
Title: Stage 1
Author: Dries De Clercq <26-6-56>

;Level 66
#####___
#---####
#----*-#
##.*$$@#
##$-.-##
#--.*-#_
#---###_
#####___
Title: Stage 2
Author: Dries De Clercq <26-6-56b>

;Level 67
__####__
###--##_
#-.--@##
#-*-*$-#
#-*$.#-#
#--$.--#
###--###
__####__
Title: Love Lines
Author: Dries De Clercq <26-6-56c>

;Level 68
#######_
#-----#_
#...$-##
#--$$--#
###+$#-#
__#*-*-#
__#---##
__#####_
Title: The Eating Horse
Author: Dries De Clercq <26-6-56d>

;Level 69
_####__
_#-@###
_#**.-#
_#-$--#
##.#--#
#---$-#
#..$$##
#----#_
######_
Title: Co-existence
Author: Dries De Clercq <26-6-57>

;Level 70
####____
#--###__
#.--.###
#-$#$-@#
#-$.**-#
#----$-#
##-.-###
_#####__
Title: Usual
Author: Dries De Clercq <26-6-57b>

;Level 71
_####___
##@-###_
#-**--##
#--**.-#
#-*-$--#
##---###
_##--#__
__#--#__
__####__
Title: Melting
Author: Dries De Clercq <26-6-58>

;Level 72
___####_
__##--#_
__#---##
_##-**-#
##-..--#
#-$-$$.#
#-.$@###
#--###__
####____
Title: Candidates
Author: Dries De Clercq <26-6-59>

;Level 73
_####__
_#@-##_
_#-*-#_
##$.-#_
#--.$##
#*$---#
#-.-*-#
#----##
######_
Title: Sequence
Author: Dries De Clercq <26-6-60>

;Level 74
__#####_
__#---##
###-.--#
#--$-#.#
#-$@*$-#
###**.-#
__#----#
__######
Title: Guilty Pleasures
Author: Dries De Clercq <26-6-60b>

;Level 75
####____
#@-###__
#-$-.#__
#-*-$##_
##*-*-#_
_#-.*-##
_#-----#
_###---#
___#####
Title: The Passage
Author: Dries De Clercq <26-6-63>

;Level 76
#######_
#-+-.-##
#---*$-#
###$.--#
__#--*-#
__#$#$-#
__#--.-#
__######
Title: Pinguin
Author: Dries De Clercq <26-6-63b>

;Level 77
_#####__
##---###
#-$#---#
#-.*$..#
#-$--@-#
##-*$###
_#-.-#__
_#####__
Title: The Art Of Symmetry
Author: Dries De Clercq <26-6-63c>

;Level 78
####___
#--####
#--*--#
#-$--.#
##-*#-#
_#--*-#
_#-$.$#
_##-.@#
__#####
Title: Magnetic
Author: Dries De Clercq <26-6-66>

;Level 79
___####_
___#--#_
####--##
#---$.-#
#--**--#
#-$+$#-#
##-*-.-#
_#######
Title: Wicked Warehouse
Author: Dries De Clercq <26-6-66b>

;Level 80
__#####
###---#
#.*..-#
#--$*-#
#.#---#
#---$-#
###$$##
__#-@#_
__####_
Title: Lost in magic
Author: Dries De Clercq <26-6-67>

;Level 81
#####___
#.--###_
#-#$--#_
#--.-.##
#.*-*$-#
#--$-$@#
####--##
___####_
Title: Till The End
Author: Dries De Clercq <26-6-67b>

;Level 82
_######
_#----#
_#$*$.#
_#--#.#
##-*@-#
#--*.-#
#-$--##
#--###_
####___
Title: Peninsula
Author: Dries De Clercq <26-6-68>

;Level 83
__####__
###.-#__
#-$--#__
#--$-###
#..#---#
#@*.$$-#
##-*---#
_#######
Title: Spiral
Author: Dries De Clercq <26-6-68b>

;Level 84
___#####
___#@--#
####$$-#
#---.$-#
#-.$#-.#
##$-.*-#
_#-.--##
_######_
Title: Immobile
Author: Dries De Clercq <26-6-68c>

;Level 85
#####___
#-.-####
#----$@#
##$-*$*#
_#-#-*-#
_#-.-.-#
_###---#
___#####
Title: +.
Author: Dries De Clercq <26-6-69>

;Level 86
__####__
__#--#__
###--###
#--*$$@#
#-#--*$#
#.-..$.#
##-----#
_#######
Title: With Honor
Author: Dries De Clercq <26-6-69b>

;Level 87
__####__
__#--##_
###.$-##
#--*-$-#
#-$-*$@#
#-#-.-##
#-.-.-#_
#######_
Title: Organised chaos
Author: Dries De Clercq <26-6-69c>

;Level 88
#####___
#-+-##__
#$-$-###
#-*..--#
#-$-$--#
#.$#-###
#-.--#__
######__
Title: Y .
Author: Dries De Clercq <26-6-69d>

;Level 89
####_____
#--##____
#.$-#####
#--..---#
##-$-$--#
_#$*.-###
_#@*--#__
_######__
Title: Traffic
Author: Dries De Clercq <26-6-70>

;Level 90
#######_
#---$.##
#.-$--+#
####$.$#
___#-*-#
___#-*-#
___#---#
___#---#
___#####
Title: In The Line
Author: Dries De Clercq <26-6-71>

;Level 91
__####_
__#--#_
###--#_
#--*-#_
#.-.-#_
#-$.$##
##$*$-#
_#--.@#
_###--#
___####
Title: Pacman
Author: Dries De Clercq <26-6-71b>

;Level 92
_#######
_#-*-.-#
_#-.---#
_#-.$###
##$.-#__
#.-$$#__
#--$@#__
#--###__
####____
Title: 1 for 1
Author: Dries De Clercq <26-6-71c>

;Level 93
__####__
###--#__
#-$$-##_
#-*---#_
#-.$#-##
#@*.*--#
##---.-#
_#######
Title: Cosy
Author: Dries De Clercq <26-6-71d>

;Level 94
######__
#-*--#__
#-..$###
#--$---#
##..$--#
#-$$-###
#--+##__
#####___
Title: abf
Author: Dries De Clercq <26-6-72>

;Level 95
__####__
__#-@#__
__#$$#__
__#-.###
###$..-#
#-$-$--#
#--*.-##
#----.#_
#######_
Title: Divided in 3
Author: Dries De Clercq <26-6-72b>

;Level 96
__#####_
__#-@.#_
__#-.$#_
__#-*-#_
_##$*-##
##--$--#
#--*.--#
#---####
#####___
Title: Not just yet
Author: Dries De Clercq <26-6-73>

;Level 97
___####_
___#--#_
####$.##
#-$----#
#@.**.-#
#$$----#
#.-#####
#--#____
####____
Title: The Center
Author: Dries De Clercq <26-6-73b>

;Level 98
__####__
__#--#__
###-$###
#--$.-.#
#-.-.--#
###$*-$#
__#@*--#
__###--#
____####
Title: The Iron Curtain
Author: Dries De Clercq <26-6-73c>

;Level 99
__####__
__#--###
__#-.-.#
###-**-#
#-@$$.-#
#-$--$-#
#####.-#
____#--#
____####
Title: Rotation
Author: Dries De Clercq <26-6-74>

;Level 100
___#####
_###---#
##---$-#
#-$.*-##
#..$.-#_
#---.##_
###$$#__
__#-@#__
__####__
Title: ?
Author: Dries De Clercq <26-6-74b>

;Level 101
___####
__##--#
###-.-#
#-$-$.#
#.*---#
#---*-#
###.$##
__#$-#_
__#@-#_
__####_
Title: Elevators 1
Author: Dries De Clercq <26-6-74c>

;Level 102
####____
#@-#####
#.$-.--#
#-$*.*-#
##-$--##
_#-$-##_
_#-.-#__
_#--##__
_####___
Title: South-America
Author: Dries De Clercq <26-6-75>

;Level 103
___#####
####.--#
#-+$.$-#
#-$-..##
###$$-#_
__#-$.#_
__#---#_
__#---#_
__#####_
Title: Into the deep
Author: Dries De Clercq <26-6-75b>

;Level 104
####____
#--###__
#-$--#__
#--.$###
##$.$.@#
_#.--$-#
_#-*-###
_#-.-#__
_#####__
Title: Shrinking
Author: Dries De Clercq <26-6-76>

;Level 105
__####__
__#-@###
__#$$--#
_##.*--#
_#-*-*##
##-*.-#_
#-----#_
#---###_
#####___
Title: Pacman 2
Author: Dries De Clercq <26-6-76b>

;Level 106
####___
#--##__
#-.-###
#---$-#
##.$..#
_#-*$@#
_#-.$-#
_#-$###
_#--#__
_####__
Title: Complex switches
Author: Dries De Clercq <26-6-77>

;Level 107
_####___
_#--#___
##-$####
#-.--$@#
#--**-.#
#-*-*--#
###--###
__#--#__
__####__
Title: Birdie
Author: Dries De Clercq <26-6-78>

;Level 108
__####__
__#--#__
###--###
#-$.-$-#
#--*-.-#
#-$*-###
##-.$#__
_#-.@#__
_#####__
Title: Crashing Birdie
Author: Dries De Clercq <26-6-78b>

;Level 109
__####__
###@-#__
#.-$$#__
#.-*-###
##$.$.-#
_#-*---#
_#---###
_#---#__
_#####__
Title: Divided in 5
Author: Dries De Clercq <26-6-80>

;Level 110
_####___
_#--#___
_#.-#___
_#$-#___
##.-####
#-*-$@-#
#-*$*--#
#---.--#
########
Title: Bigfoot
Author: Dries De Clercq <26-6-80b>

;Level 111
__####__
__#--##_
###-.-#_
#-$*--##
#..-.$-#
#-$*-$@#
###--###
__#--#__
__####__
Title: Extension
Author: Dries De Clercq <26-6-80c>

;Level 112
___#####
_###-.-#
##-$---#
#-.--*##
#---*-#_
###.$-#_
__#$*-#_
__#-@##_
__####__
Title: Tension
Author: Dries De Clercq <26-6-80d>

;Level 113
__####__
__#--###
__#$---#
__#-.-.#
###$.-##
#--$*-#_
#@*-.$#_
###---#_
__#####_
Title: The Big Center
Author: Dries De Clercq <26-6-81>

;Level 114
__####__
__#--#__
###--###
#@$--$-#
#.**$..#
#--$---#
#.-#####
#--#____
####____
Title: The Passage
Author: Dries De Clercq <26-6-82>

;Level 115
####___
#--#___
#--###_
#-$--##
#.-**-#
#-$.*@#
##---##
_#-*-#_
_#--##_
_####__
Title: Blockie
Author: Dries De Clercq <26-6-83>

;Level 116
__######_
__#--*-#_
###.*--##
#--*-.--#
#--$.$--#
###-$####
__#@-#___
__####___
Title: Godlike
Author: Dries De Clercq <26-6-106>
Comment:
This level was not generated and it came as a big surprise to me that none of the levels
I've made and generated later on even came close to those 106 pushes.
It is even doubtful that there is a level with 27 unit squares that goes to more than 106
(unless, of course, when you add a floor tile and a box to this level ).
The very best I've found with 27 unit squares reached 102 pushes.

Comment-End:

;Level 117
####___
#--####
#--$--#
#.$..-#
#-*-$.#
#$-*$-#
#--.@##
######_
Title: T-time
Author: Dries De Clercq <26-7-74>
